115 30 144 16 16 4 29
0 0 0 0 0 0 0 0 0 0 0 0 0 0 0 0 0 0 0 0 0 0 0 0 0 0 0 0 0 0 0 0 0 0 0 0 0 0 0 0 0 0 0 0 0 0 0 0 0 0 0 0 0 0 0 0 0 0 0 0 0 0 0 0 0 0 0 0 0 0 0 0 0 0 0 0 0 0 0 0 0 0 0 0 0 0 0 0 0 0 0 0 0 0 0 0 0 0 0 0 0 0 0 0 0 0 0 0 0 0 0 0 0 0 0 0 0 0 0 0 0 0 0 0 0 0 0 0 1 1 1 1 1 1 1 1 1 1 1 1 1 1 1 1 
0 0 0 0 0 0 0 0 0 0 0 0 0 0 0 0 0 0 0 0 0 0 0 0 0 0 0 0 0 0 0 0 0 0 0 0 0 0 0 0 0 0 0 0 0 0 0 0 0 0 0 0 0 0 0 0 0 0 0 0 0 0 0 0 0 0 0 0 0 0 0 0 0 0 0 0 0 0 0 0 0 0 0 0 0 0 0 0 0 0 0 0 0 0 0 0 0 0 0 0 0 0 0 0 0 0 0 0 0 0 0 0 0 0 0 0 0 0 0 0 0 0 0 0 0 0 0 0 1 1 1 1 1 1 1 1 1 1 1 1 1 1 1 1 
0 0 0 0 0 0 2 0 2 0 0 0 0 0 0 0 0 0 0 0 0 0 2 0 2 0 0 0 0 0 0 0 0 0 0 0 0 0 2 0 2 0 0 0 0 0 0 0 0 0 0 0 0 0 2 0 2 0 0 0 0 0 0 0 0 0 0 0 0 0 2 0 2 0 0 0 0 0 0 0 0 0 0 0 0 0 2 0 2 0 0 0 0 0 0 0 0 0 0 0 0 0 2 0 2 0 0 0 0 0 0 0 0 0 0 0 0 0 0 0 0 0 0 0 0 0 0 0 1 1 1 1 1 1 1 1 1 1 1 1 1 1 1 1 
0 0 0 0 0 0 3 4 4 0 0 0 0 0 0 0 0 0 0 0 0 0 3 4 4 0 0 0 0 0 0 0 0 0 0 0 0 0 3 4 4 0 0 0 0 0 0 0 0 0 0 0 0 0 3 4 4 0 0 0 0 0 0 0 0 0 0 0 0 0 3 4 4 0 0 0 0 0 0 0 0 0 0 0 0 0 3 4 4 0 0 0 0 0 0 0 0 0 0 0 0 0 3 4 4 0 0 0 0 0 0 0 0 0 0 0 0 0 0 0 0 0 0 0 0 0 0 0 1 1 1 1 1 1 1 1 1 1 1 1 1 1 1 1 
0 0 0 0 0 0 5 6 6 0 0 0 0 0 0 0 0 0 0 0 0 0 5 6 6 0 0 0 0 0 0 0 0 0 0 0 0 0 5 6 6 0 0 0 0 0 0 0 0 0 0 0 0 0 5 6 6 0 0 0 0 0 0 0 0 0 0 0 0 0 5 6 6 0 0 0 0 0 0 0 0 0 0 0 0 0 5 6 6 0 0 0 0 0 0 0 0 0 0 0 0 0 5 6 6 0 0 0 0 0 0 0 0 0 0 0 0 0 0 0 0 0 0 0 0 0 0 0 1 1 1 1 1 1 1 1 1 1 1 1 1 1 1 1 
0 0 0 0 0 0 5 6 6 0 0 0 0 0 0 0 0 0 0 0 0 0 5 6 6 0 0 0 0 0 0 0 0 0 0 0 0 0 5 6 6 0 0 0 0 0 0 0 0 0 0 0 0 0 5 6 6 0 0 0 0 0 0 0 0 0 0 0 0 0 5 6 6 0 0 0 0 0 0 0 0 0 0 0 0 0 5 6 6 0 0 0 0 0 0 0 0 0 0 0 0 0 5 6 6 0 0 0 0 0 0 0 0 0 0 0 0 0 0 0 0 0 0 0 0 0 0 0 1 1 1 1 1 1 1 1 1 1 1 1 1 1 1 1 
0 0 0 0 2 0 5 6 6 0 0 0 0 0 0 0 0 0 0 0 2 0 5 6 6 0 0 0 0 0 0 0 0 0 0 0 2 0 5 6 6 0 0 0 0 0 0 0 0 0 0 0 2 0 5 6 6 0 0 0 0 0 0 0 0 0 0 0 2 0 5 6 6 0 0 0 0 0 0 0 0 0 0 0 2 0 5 6 6 0 0 0 0 0 0 0 0 0 0 0 2 0 5 6 6 0 0 0 0 0 0 0 0 0 0 0 0 0 0 0 0 0 0 0 0 0 0 0 1 1 1 1 1 1 1 1 1 1 1 1 1 1 1 1 
0 0 0 0 7 8 8 6 6 0 0 0 2 0 0 0 0 0 0 0 7 8 8 6 6 0 0 0 2 0 0 0 0 0 0 0 7 8 8 6 6 0 0 0 2 0 0 0 0 0 0 0 7 8 8 6 6 0 0 0 2 0 0 0 0 0 0 0 7 8 8 6 6 0 0 0 2 0 0 0 0 0 0 0 7 8 8 6 6 0 0 0 2 0 0 0 0 0 0 0 7 8 8 6 6 0 0 0 2 0 0 0 0 0 0 0 0 0 0 0 0 0 0 0 0 0 0 0 1 1 1 1 1 1 1 1 1 1 1 1 1 1 1 1 
0 0 0 0 9 10 10 6 6 0 0 0 3 4 0 0 0 0 0 0 9 10 10 6 6 0 0 0 3 4 0 0 0 0 0 0 9 10 10 6 6 0 0 0 3 4 0 0 0 0 0 0 9 10 10 6 6 0 0 0 3 4 0 0 0 0 0 0 9 10 10 6 6 0 0 0 3 4 0 0 0 0 0 0 9 10 10 6 6 0 0 0 3 4 0 0 0 0 0 0 9 10 10 6 6 0 0 0 3 4 0 0 0 0 0 0 0 0 0 0 0 0 0 0 0 0 0 0 1 1 1 1 1 1 1 1 1 1 1 1 1 1 1 1 
0 0 0 0 9 10 10 6 6 2 0 0 5 6 2 0 0 0 0 0 9 10 10 6 6 2 0 0 5 6 2 0 0 0 0 0 9 10 10 6 6 2 0 0 5 6 2 0 0 0 0 0 9 10 10 6 6 2 0 0 5 6 2 0 0 0 0 0 9 10 10 6 6 2 0 0 5 6 2 0 0 0 0 0 9 10 10 6 6 2 0 0 5 6 2 0 0 0 0 0 9 10 10 6 6 2 0 0 5 6 2 0 0 0 0 0 0 0 0 0 0 0 0 0 0 0 0 0 1 1 1 1 1 1 1 1 1 1 1 1 1 1 1 1 
0 0 0 0 9 10 10 6 7 8 0 2 5 7 8 0 0 0 0 0 9 10 10 6 7 8 0 2 5 7 8 0 0 0 0 0 9 10 10 6 7 8 0 2 5 7 8 0 0 0 0 0 9 10 10 6 7 8 0 2 5 7 8 0 0 0 0 0 9 10 10 6 7 8 0 2 5 7 8 0 0 0 0 0 9 10 10 6 7 8 0 2 5 7 8 0 0 0 0 0 9 10 10 6 7 8 0 2 5 7 8 0 0 0 0 0 0 0 0 0 0 0 0 0 0 0 0 0 1 1 1 1 1 1 1 1 1 1 1 1 1 1 1 1 
0 0 0 0 9 10 10 6 9 10 0 3 5 9 10 0 0 0 0 0 9 10 10 6 9 10 0 3 5 9 10 0 0 0 0 0 9 10 10 6 9 10 0 3 5 9 10 0 0 0 0 0 9 10 10 6 9 10 0 3 5 9 10 0 0 0 0 0 9 10 10 6 9 10 0 3 5 9 10 0 0 0 0 0 9 10 10 6 9 10 0 3 5 9 10 0 0 0 0 0 9 10 10 6 9 10 0 3 5 9 10 0 0 0 0 0 0 0 0 0 0 0 0 0 0 0 0 0 1 1 1 1 1 1 1 1 1 1 1 1 1 1 1 1 
0 0 11 12 12 12 12 12 12 12 12 12 12 12 12 13 0 0 11 12 12 12 12 12 12 12 12 12 12 12 12 13 0 0 11 12 12 12 12 12 12 12 12 12 12 12 12 13 0 0 11 12 12 12 12 12 12 12 12 12 12 12 12 13 0 0 11 12 12 12 12 12 12 12 12 12 12 12 12 13 0 0 11 12 12 12 12 12 12 12 12 12 12 12 12 13 0 0 11 12 12 12 12 12 12 12 12 12 12 12 12 13 0 0 0 0 0 0 0 0 0 0 0 0 0 0 0 0 1 1 1 1 1 1 1 1 1 1 1 1 1 1 1 1 
0 0 14 15 15 15 15 15 15 15 15 15 15 15 15 15 0 0 14 15 15 15 15 15 15 15 15 15 15 15 15 15 0 0 14 15 15 15 15 15 15 15 15 15 15 15 15 15 0 0 14 15 15 15 15 15 15 15 15 15 15 15 15 15 0 0 14 15 15 15 15 15 15 15 15 15 15 15 15 15 0 0 14 15 15 15 15 15 15 15 15 15 15 15 15 15 0 0 14 15 15 15 15 15 15 15 15 15 15 15 15 15 0 0 0 0 0 0 0 0 0 0 0 0 0 0 0 0 1 1 1 1 1 1 1 1 1 1 1 1 1 1 1 1 
0 0 14 16 16 16 16 16 16 16 16 16 16 16 16 16 0 0 14 16 16 16 16 16 16 16 16 16 16 16 16 16 0 0 14 16 16 16 16 16 16 16 16 16 16 16 16 16 0 0 14 16 16 16 16 16 16 16 16 16 16 16 16 16 0 0 14 16 16 16 16 16 16 16 16 16 16 16 16 16 0 0 14 16 16 16 16 16 16 16 16 16 16 16 16 16 0 0 14 16 16 16 16 16 16 16 16 16 16 16 16 16 0 0 0 0 0 0 0 0 0 0 0 0 0 0 0 0 1 1 1 1 1 1 1 1 1 1 1 1 1 1 1 1 
0 0 14 15 15 15 15 15 15 15 15 15 15 15 15 15 0 0 14 17 17 17 17 17 17 17 17 17 17 17 17 17 0 0 14 18 18 18 18 18 18 18 18 18 18 18 18 18 0 0 14 18 18 18 18 18 18 18 18 18 18 18 18 18 0 0 14 17 17 17 17 17 17 17 17 17 17 17 17 17 0 0 14 15 15 15 15 15 15 15 15 15 15 15 15 15 0 0 14 17 17 17 17 17 17 17 17 17 17 17 17 17 0 0 2 2 0 0 0 0 0 0 0 0 2 2 0 0 19 19 20 19 19 19 20 19 19 19 20 19 19 19 20 19 
0 0 14 16 21 16 21 16 21 16 16 22 23 22 23 16 0 0 14 24 24 22 23 24 22 23 24 22 23 24 21 25 0 0 14 26 26 21 26 26 26 26 21 26 21 26 21 26 0 0 14 26 26 21 26 26 26 26 21 26 21 26 21 26 0 0 14 24 24 22 23 24 22 23 24 22 23 24 21 25 0 0 14 27 28 29 21 16 21 16 16 22 23 22 23 16 0 0 14 24 24 22 23 24 22 23 24 22 23 24 21 25 0 0 7 8 0 0 0 2 0 0 0 3 7 8 0 0 30 30 30 30 30 30 30 30 30 30 30 30 30 30 30 30 
0 0 14 16 31 16 31 16 31 16 16 32 33 32 33 16 0 0 14 24 24 34 35 24 34 35 24 34 35 24 36 25 0 2 14 26 26 36 26 37 13 26 36 26 36 26 36 26 0 2 14 26 26 36 26 37 13 26 36 26 36 26 36 26 0 0 14 24 24 34 35 24 34 35 24 34 35 24 36 25 0 0 14 38 31 39 31 16 31 16 16 32 33 32 33 16 0 0 14 24 24 34 35 24 34 35 24 34 35 24 36 25 0 0 9 10 0 0 2 3 4 2 0 5 9 10 2 0 40 40 40 40 40 40 40 40 40 40 40 40 40 40 40 40 
0 0 14 16 36 16 36 16 36 16 16 34 35 34 35 16 0 0 14 24 24 17 17 24 17 17 24 17 17 24 17 25 0 7 41 26 26 18 26 18 18 26 18 26 18 26 18 26 0 7 41 26 26 18 26 18 18 26 18 26 18 26 18 26 0 0 14 24 24 17 17 24 17 17 24 17 17 24 17 25 0 0 14 42 36 43 36 16 36 16 16 34 35 34 35 16 0 0 14 24 24 17 17 24 17 17 24 17 17 24 17 25 0 0 9 10 0 0 7 8 6 7 0 5 3 4 4 0 40 40 40 40 40 40 40 40 40 40 40 40 40 40 40 40 
0 0 41 37 12 13 15 16 15 16 16 15 15 15 15 16 2 2 41 44 44 44 44 44 44 44 44 44 44 44 44 44 0 9 45 44 44 44 44 44 44 44 44 44 44 44 44 44 0 9 45 44 44 44 44 44 44 44 44 44 44 44 44 44 2 2 41 44 44 44 44 44 44 44 44 44 44 44 44 44 0 0 41 37 12 13 15 16 15 16 16 15 15 15 15 16 2 2 41 44 44 44 44 44 44 44 44 44 44 44 44 44 46 46 46 46 46 46 46 46 46 46 46 46 46 46 46 46 40 40 40 40 40 47 40 40 40 40 40 40 40 40 40 40 
0 0 45 44 44 44 44 44 44 44 44 44 44 44 44 44 3 4 45 48 49 50 51 52 53 17 17 17 17 17 17 17 0 9 45 54 55 56 18 18 18 18 18 18 18 18 18 18 0 9 45 54 55 57 18 18 18 18 18 18 18 18 18 18 3 4 45 17 17 17 51 52 53 17 17 17 17 17 17 17 0 0 45 44 44 44 44 44 44 44 44 44 44 44 44 44 3 4 45 17 17 17 51 52 53 17 17 17 17 17 17 17 58 59 58 59 58 59 58 59 58 59 58 59 58 59 58 59 40 40 40 40 40 40 40 40 40 40 40 40 40 40 40 40 
0 0 45 15 15 15 15 60 61 62 15 15 15 15 15 15 5 6 45 63 64 65 22 66 23 24 21 24 21 24 21 25 0 9 45 67 68 69 26 26 26 26 26 26 26 26 26 26 0 9 45 26 26 26 26 26 26 26 26 26 26 26 26 26 5 6 45 24 21 24 22 66 23 24 21 24 21 24 21 25 0 0 45 15 15 15 15 15 15 15 15 15 15 15 15 15 5 6 45 24 21 24 22 66 23 24 21 24 21 24 21 25 59 58 59 58 59 58 59 58 59 58 59 58 59 58 58 70 40 40 40 71 72 73 40 40 40 40 40 47 40 40 40 40 
0 0 45 16 21 16 21 74 75 76 16 22 23 22 23 16 5 6 45 63 77 65 32 78 33 24 31 24 31 24 31 25 0 9 45 26 37 13 26 26 21 26 37 12 13 26 21 26 0 9 45 26 37 13 26 26 21 26 37 12 13 26 21 26 5 6 45 24 31 24 32 78 33 24 31 24 31 24 31 25 0 0 45 16 21 16 21 16 21 16 16 22 23 22 23 16 5 6 45 24 31 24 32 78 33 24 31 24 31 24 31 25 44 44 44 44 44 44 44 44 44 44 44 44 44 44 58 59 40 40 40 40 40 40 40 40 40 40 40 40 40 40 40 40 
0 0 45 16 31 16 31 74 79 76 16 32 33 32 33 16 5 7 45 63 80 65 32 78 33 24 36 24 36 24 36 25 3 9 45 26 18 18 26 26 36 26 22 66 23 26 36 26 3 9 45 26 18 18 26 26 36 26 22 66 23 26 36 26 5 7 45 24 36 24 32 78 33 24 36 24 36 24 36 25 0 0 45 16 31 16 31 16 31 16 16 32 33 32 33 16 5 7 45 24 36 24 32 78 33 24 36 24 36 24 36 25 81 82 81 82 81 82 81 82 81 82 81 82 81 82 58 70 40 47 40 40 40 40 40 40 40 40 40 40 40 40 40 40 
83 83 45 16 36 16 36 74 84 76 16 34 35 34 35 16 5 9 45 85 86 65 34 44 35 24 17 24 17 24 17 25 5 9 45 26 26 26 26 26 18 26 32 78 33 26 18 26 5 9 45 26 26 26 26 26 18 26 32 78 33 26 18 26 5 9 45 24 17 24 34 44 35 24 17 24 17 24 17 25 83 83 45 16 36 16 36 16 36 16 16 34 35 34 35 16 5 9 45 24 17 24 34 44 35 24 17 24 17 24 17 25 81 81 81 81 81 81 81 81 81 81 81 81 81 81 58 59 40 40 40 40 40 40 40 40 40 40 40 40 40 40 40 40 
81 81 45 16 15 16 15 87 88 76 16 15 15 15 15 16 5 9 45 89 90 91 92 93 94 95 95 95 95 95 95 95 5 9 45 95 95 95 95 95 95 95 34 44 35 95 95 95 5 9 45 95 95 95 95 95 95 95 34 44 35 95 95 95 5 9 45 95 95 95 92 93 94 95 95 95 95 95 95 95 81 81 45 16 15 16 15 16 15 16 16 15 15 15 15 16 5 9 45 95 95 95 92 93 94 95 95 95 95 95 95 95 81 81 81 81 81 82 81 82 81 82 81 82 81 82 58 70 40 40 40 40 40 40 40 40 40 40 40 40 40 40 40 40 
96 96 97 96 96 96 96 96 96 96 96 96 96 96 96 96 96 96 97 98 98 98 92 93 94 98 98 98 98 98 98 98 96 96 97 98 98 98 98 98 98 98 92 93 94 98 98 98 96 96 97 98 98 98 98 98 98 98 92 93 94 98 98 98 96 96 97 98 98 98 92 93 94 98 98 98 98 98 98 98 96 96 97 96 96 96 96 96 96 96 96 96 96 96 96 96 96 96 97 98 98 98 92 93 94 98 98 98 98 98 98 98 46 46 46 70 99 99 99 99 99 99 99 99 99 99 58 59 100 100 100 100 100 100 100 100 100 100 100 100 100 100 100 100 
101 101 101 101 101 102 103 104 103 104 105 101 101 101 101 101 101 101 101 101 101 101 101 101 101 101 101 101 101 101 101 101 101 101 101 101 101 101 101 101 101 101 101 101 101 101 101 101 101 101 101 101 101 101 101 101 101 101 101 101 101 101 101 101 101 101 101 101 101 101 101 101 101 101 101 101 101 101 101 101 101 101 101 101 101 102 103 104 103 104 105 101 101 101 101 101 101 101 101 101 101 101 101 101 101 101 101 101 101 101 101 101 58 59 58 59 106 46 70 46 46 46 46 46 46 46 58 59 107 107 107 107 107 107 107 107 107 107 107 107 107 107 107 107 
108 108 108 108 108 108 108 108 108 108 108 108 108 108 108 108 108 108 108 108 108 108 108 108 108 108 108 108 108 108 108 108 108 108 108 108 108 108 108 108 108 108 108 108 108 108 108 108 108 108 108 108 108 108 108 108 108 108 108 108 108 108 108 108 108 108 108 108 108 108 108 108 108 108 108 108 108 108 108 108 108 108 108 108 108 108 108 108 108 108 108 108 108 108 108 108 108 108 108 108 108 108 108 108 108 108 108 108 108 108 108 108 59 59 109 110 59 58 59 58 59 58 59 58 59 58 58 59 81 81 81 81 81 81 81 81 81 81 81 81 81 81 81 81 
111 111 111 111 111 111 111 111 111 111 111 111 111 111 111 111 111 111 111 111 111 111 111 111 111 111 111 111 111 111 111 111 111 111 111 111 111 111 111 111 111 111 111 111 111 111 111 111 111 111 111 111 111 111 111 111 111 111 111 111 111 111 111 111 111 111 111 111 111 111 111 111 111 111 111 111 111 111 111 111 111 111 111 111 111 111 111 111 111 111 111 111 111 111 111 111 111 111 111 111 111 111 111 111 111 111 111 111 111 111 111 111 112 113 112 113 112 113 112 113 112 113 112 113 112 113 113 112 114 114 114 114 114 114 114 114 114 114 114 114 114 114 114 114 
