0 0 0 249 107 19 28 0 0 0 
1 0 0 294 106 22 29 0 0 0 
2 0 0 343 108 20 27 0 0 0 
3 0 0 441 103 20 32 0 0 0 
4 0 0 1287 71 19 28 0 1282 1357 
5 0 0 1445 71 16 27 0 1442 1455 
6 0 0 1482 40 18 25 0 1474 1518 
7 0 0 1880 107 18 25 0 1799 2030 
8 0 0 1958 106 22 28 0 1799 2030 
9 1 0 331 91 12 16 5 0 0 0 
10 1 0 428 90 13 15 5 0 0 0 
11 1 0 573 90 13 13 6 0 0 0 
12 1 0 769 59 9 16 8 0 0 0 
13 1 0 892 26 11 16 10 0 0 0 
14 1 0 635 75 8 14 7 0 0 0 
15 1 0 1152 91 10 14 6 0 0 0 
16 1 0 1182 27 8 13 1 0 0 0 
17 1 0 1326 27 12 13 6 0 0 0 
18 1 0 1662 90 12 13 11 0 0 0 
19 1 0 1856 94 10 12 9 0 0 0 
20 2 0 555 28 14 14 0 0 0 0 
21 2 0 714 30 14 13 0 0 0 0 
22 2 1 1568 47 12 12 0 0 0 0 
23 2 1 1722 30 16 14 0 0 0 0 
24 2 0 1866 31 16 14 0 0 0 0 
25 2 0 1053 43 15 15 0 0 0 0 
26 3 0 1267 80 18 15 0 0 0 0 
27 3 0 885 30 18 14 0 0 0 0 
28 4 0 810 60 18 23 0 800 805 
29 4 0 1230 30 13 22 0 1216 1234 
30 5 0 1367 95 15 28 0 0 0 0 
31 3 1 930 30 18 14 0 0 0 0 